. G G G B G G G G G . . . . S
. G G E E G G E G G . G B G G
. B G E E G G E G G . G G G G
. G G E E B G E B G . G E E E
. G G E E G G E G G . G E E E
. . G E E G G E G G . G E E E
G . G G G G B G B G . G G G G
G . . . . G G G G G . G G G G
E G G G . G G G G G . G G G E
E E G G . . . D . . . G G E E
