. . . . . . G G B G B G G . S
G E E G G . G G G G G G G . G
G E E G G . G E E E E E G . G
B E E B G . G E E E E E G . G
E E E E G . G G G G G G G . G
E E E E G . G B G G . . . . G
G E E G G . G E E G . G G G G
G B B G G . E E E E . G E E G
E G G G G . G E E G . G E E G
E E G G G . . D . . . G G G G